5 10
##########
#S.......#
##.#####.#
##.#.....#
##########